nlevels,reps,treatment_code,propagule_id_new,leaf_mass,stem_mass,propagule_mass
10,1,10_1,M1,91,23,114
10,1,10_1,M2,38,23,61
10,1,10_1,M3,49,33,82
10,1,10_1,M4,44,77,121
10,1,10_1,M5,25,83,108
10,1,10_1,M6,35,95,130
10,1,10_1,M7,45,85,130
10,1,10_1,M8,13,86,99
10,1,10_1,M9,51,113,164
10,1,10_1,M10,12,78,90
10,1,10_1,M11,13,60,73
10,1,10_1,M12,0,107,107
10,1,10_1,M13,0,84,84
10,1,10_1,M14,0,116,116
10,1,10_1,B1,2,8,10
10,1,10_1,B2,4,11,15
10,1,10_1,B3,50,14,64
10,1,10_1,B4,17,18,35
10,1,10_1,B5,11,27,38
10,1,10_1,B6,8,27,35
10,1,10_1,B7,4,1,5
10,1,10_1,B8,1,1,2
10,1,10_1,B9,1,1,2
10,1,10_1,B10,23,1,24
10,1,10_1,B11,14,3,17
10,1,10_1,B12,8,14,22
10,1,10_1,B13,1,23,24
10,1,10_1,B14,1,25,26
20,1,20_1,M1,62,1,63
20,1,20_1,M2,36,1,37
20,1,20_1,M3,43,10,53
20,1,20_1,M4,34,29,63
20,1,20_1,M5,49,62,111
20,1,20_1,M6,48,77,125
20,1,20_1,M7,41,86,127
20,1,20_1,M8,34,74,108
20,1,20_1,M9,8,76,84
20,1,20_1,M10,11,70,81
20,1,20_1,M11,0,75,75
20,1,20_1,M12,0,110,110
20,1,20_1,M13,0,92,92
20,1,20_1,M14,0,138,138
20,1,20_1,B1,2,1,3
20,1,20_1,B2,19,5,24
20,1,20_1,B3,13,6,19
20,1,20_1,B4,1,22,23
20,1,20_1,B5,5,1,6
20,1,20_1,B6,68,23,91
20,1,20_1,B7,24,28,52
20,1,20_1,B8,11,35,46
20,1,20_1,B9,1,28,29
20,1,20_1,B10,61,5,66
20,1,20_1,B11,22,24,46
20,1,20_1,B12,18,49,67
20,1,20_1,B13,11,61,72
20,1,20_1,B14,1,59,60
20,1,20_1,B15,1,6,7
20,1,20_1,B16,0,15,15
20,1,20_1,B17,0,9,9
20,1,20_1,B18,0,12,12
40,1,40_1,M1,41,15,56
40,1,40_1,M2,49,38,87
40,1,40_1,M3,42,68,110
40,1,40_1,M4,42,103,145
40,1,40_1,M5,43,98,141
40,1,40_1,M6,42,86,128
40,1,40_1,M7,41,74,115
40,1,40_1,M8,36,63,99
40,1,40_1,M9,6,61,67
40,1,40_1,M10,28,63,91
40,1,40_1,M11,0,58,58
40,1,40_1,M12,0,50,50
40,1,40_1,M13,0,94,94
40,1,40_1,B1,10,1,11
40,1,40_1,B2,1,1,2
40,1,40_1,B3,12,1,13
40,1,40_1,B4,3,1,4
40,1,40_1,B5,24,8,32
40,1,40_1,B6,10,17,27
40,1,40_1,B7,13,24,37
40,1,40_1,B8,6,22,28
40,1,40_1,B9,57,1,58
40,1,40_1,B10,25,6,31
40,1,40_1,B11,20,18,38
40,1,40_1,B12,11,25,36
40,1,40_1,B13,1,25,26
40,1,40_1,B14,28,8,36
40,1,40_1,B15,20,22,42
40,1,40_1,B16,9,27,36
40,1,40_1,B17,1,23,24
40,1,40_1,B18,6,1,7
40,1,40_1,B19,1,1,2
60,1,60_1,M1,66,5,71
60,1,60_1,M2,42,6,48
60,1,60_1,M3,46,13,59
60,1,60_1,M4,43,29,72
60,1,60_1,M5,37,60,97
60,1,60_1,M6,35,80,115
60,1,60_1,M7,37,110,147
60,1,60_1,M8,39,108,147
60,1,60_1,M9,47,95,142
60,1,60_1,M10,47,105,152
60,1,60_1,M11,31,100,131
60,1,60_1,M12,13,79,92
60,1,60_1,M13,8,9,17
60,1,60_1,M14,0,61,61
60,1,60_1,M15,0,192,192
60,1,60_1,M16,88,4,92
60,1,60_1,M17,44,9,53
60,1,60_1,M18,44,20,64
60,1,60_1,M19,46,44,90
60,1,60_1,M20,44,76,120
60,1,60_1,M21,40,95,135
60,1,60_1,M22,43,111,154
60,1,60_1,M23,37,93,130
60,1,60_1,M24,28,82,110
60,1,60_1,M25,11,88,99
60,1,60_1,M26,0,54,54
60,1,60_1,M27,0,60,60
60,1,60_1,M28,0,80,80
60,1,60_1,B1,24,9,33
60,1,60_1,B2,26,20,46
60,1,60_1,B3,14,30,44
60,1,60_1,B4,8,35,43
60,1,60_1,B5,39,1,40
60,1,60_1,B6,17,7,24
60,1,60_1,B7,16,15,31
60,1,60_1,B8,13,22,35
60,1,60_1,B9,2,21,23
60,1,60_1,B10,39,6,45
60,1,60_1,B11,20,7,27
60,1,60_1,B12,20,18,38
60,1,60_1,B13,10,27,37
60,1,60_1,B14,7,26,33
60,1,60_1,B15,58,5,63
60,1,60_1,B16,21,6,27
60,1,60_1,B17,18,18,36
60,1,60_1,B18,9,24,33
60,1,60_1,B19,6,25,31
60,1,60_1,B20,15,4,19
60,1,60_1,B21,15,14,29
60,1,60_1,B22,14,24,38
60,1,60_1,B23,6,24,30
60,1,60_1,B24,21,1,22
60,1,60_1,B25,11,4,15
60,1,60_1,B26,9,8,17
60,1,60_1,B27,4,10,14
60,1,60_1,B28,11,6,17
60,1,60_1,B29,10,1,11
60,1,60_1,B30,55,35,90
60,1,60_1,B31,14,17,31
60,1,60_1,B32,13,26,39
60,1,60_1,B33,1,21,22
10,2,10_2,M1,81,11,92
10,2,10_2,M2,47,22,69
10,2,10_2,M3,49,48,97
10,2,10_2,M4,46,84,130
10,2,10_2,M5,51,143,194
10,2,10_2,M6,52,177,229
10,2,10_2,M7,54,158,212
10,2,10_2,M8,0,129,129
10,2,10_2,M9,0,117,117
10,2,10_2,M10,0,99,99
10,2,10_2,M11,0,83,83
10,2,10_2,M12,0,71,71
10,2,10_2,M13,0,48,48
10,2,10_2,M14,0,139,139
10,2,10_2,B1,20,6,26
10,2,10_2,B2,6,12,18
10,2,10_2,B3,13,3,16
10,2,10_2,B4,1,9,10
10,2,10_2,B5,22,7,29
10,2,10_2,B6,6,10,16
10,2,10_2,B7,23,10,33
10,2,10_2,B8,6,8,14
10,2,10_2,B9,6,11,17
10,2,10_2,B10,1,16,17
10,2,10_2,B11,0,14,14
10,2,10_2,B12,0,28,28
10,2,10_2,B13,0,32,32
10,2,10_2,B14,0,27,27
10,2,10_2,B15,0,26,26
10,2,10_2,B16,0,23,23
20,2,20_2,M1,73,1,74
20,2,20_2,M2,48,4,52
20,2,20_2,M3,56,14,70
20,2,20_2,M4,53,28,81
20,2,20_2,M5,54,98,152
20,2,20_2,M6,48,67,115
20,2,20_2,M7,44,69,113
20,2,20_2,M8,36,72,108
20,2,20_2,M9,29,60,89
20,2,20_2,M10,21,51,72
20,2,20_2,M11,9,48,57
20,2,20_2,M12,0,49,49
20,2,20_2,M13,0,55,55
20,2,20_2,M14,0,46,46
20,2,20_2,M15,0,95,95
20,2,20_2,B1,1,1,2
20,2,20_2,B2,21,3,24
20,2,20_2,B3,13,13,26
20,2,20_2,B4,2,21,23
20,2,20_2,B5,1,19,20
20,2,20_2,B6,0,20,20
20,2,20_2,B7,0,21,21
40,2,40_2,M1,102,6,108
40,2,40_2,M2,48,9,57
40,2,40_2,M3,50,25,75
40,2,40_2,M4,51,53,104
40,2,40_2,M5,42,80,122
40,2,40_2,M6,45,98,143
40,2,40_2,M7,44,107,151
40,2,40_2,M8,40,95,135
40,2,40_2,M9,36,80,116
40,2,40_2,M10,34,95,129
40,2,40_2,M11,26,78,104
40,2,40_2,M12,8,71,79
40,2,40_2,M13,0,64,64
40,2,40_2,M14,0,74,74
40,2,40_2,M15,0,103,103
40,2,40_2,B1,7,1,8
40,2,40_2,B2,72,5,77
40,2,40_2,B3,26,12,38
40,2,40_2,B4,24,23,47
40,2,40_2,B5,16,34,50
40,2,40_2,B6,9,35,44
40,2,40_2,B7,6,5,11
40,2,40_2,B8,65,6,71
40,2,40_2,B9,27,10,37
40,2,40_2,B10,22,23,45
40,2,40_2,B11,9,32,41
40,2,40_2,B12,3,25,28
40,2,40_2,B13,45,1,46
40,2,40_2,B14,25,5,30
40,2,40_2,B15,20,17,37
40,2,40_2,B16,12,27,39
40,2,40_2,B17,1,22,23
60,2,60_2,M1,97,2,99
60,2,60_2,M2,59,8,67
60,2,60_2,M3,53,19,72
60,2,60_2,M4,55,44,99
60,2,60_2,M5,51,86,137
60,2,60_2,M6,52,119,171
60,2,60_2,M7,54,27,81
60,2,60_2,M8,53,119,172
60,2,60_2,M9,43,112,155
60,2,60_2,M10,32,108,140
60,2,60_2,M11,28,105,133
60,2,60_2,M12,10,91,101
60,2,60_2,M13,0,93,93
60,2,60_2,B1,43,1,44
60,2,60_2,B2,19,5,24
60,2,60_2,B3,16,7,23
60,2,60_2,B4,51,2,53
60,2,60_2,B5,28,6,34
60,2,60_2,B6,23,17,40
60,2,60_2,B7,28,51,79
60,2,60_2,B8,7,29,36
60,2,60_2,B9,49,4,53
60,2,60_2,B10,15,7,22
60,2,60_2,B11,11,15,26
60,2,60_2,B12,1,15,16
60,2,60_2,B13,43,5,48
60,2,60_2,B14,15,9,24
60,2,60_2,B15,9,18,27
60,2,60_2,B16,3,17,20
60,2,60_2,B17,45,2,47
60,2,60_2,B18,15,8,23
60,2,60_2,B19,12,17,29
60,2,60_2,B20,1,15,16
60,2,60_2,B21,59,2,61
60,2,60_2,B22,27,6,33
60,2,60_2,B23,17,18,35
60,2,60_2,B24,11,31,42
60,2,60_2,B25,1,25,26
60,2,60_2,B26,0,2,2
60,2,60_2,B27,0,2,2
60,2,60_2,B28,3,1,4
60,2,60_2,B29,0,10,10
60,2,60_2,B30,0,13,13
10,3,10_3,M1,49,1,50
10,3,10_3,M2,44,6,50
10,3,10_3,M3,44,14,58
10,3,10_3,M4,39,23,62
10,3,10_3,M5,39,48,87
10,3,10_3,M6,31,61,92
10,3,10_3,M7,26,60,86
10,3,10_3,M8,26,52,78
10,3,10_3,M9,13,55,68
10,3,10_3,M10,16,43,59
10,3,10_3,M11,0,39,39
10,3,10_3,M12,0,40,40
10,3,10_3,M13,0,41,41
10,3,10_3,M14,0,67,67
10,3,10_3,B1,16,1,17
10,3,10_3,B2,7,4,11
10,3,10_3,B3,1,5,6
10,3,10_3,B4,9,2,11
10,3,10_3,B5,1,1,2
10,3,10_3,B6,0,2,2
10,3,10_3,B7,0,4,4
20,3,20_3,M1,71,6,77
20,3,20_3,M2,43,8,51
20,3,20_3,M3,49,21,70
20,3,20_3,M4,52,36,88
20,3,20_3,M5,39,49,88
20,3,20_3,M6,48,73,121
20,3,20_3,M7,38,76,114
20,3,20_3,M8,30,60,90
20,3,20_3,M9,28,58,86
20,3,20_3,M10,21,67,88
20,3,20_3,M11,9,5,14
20,3,20_3,M12,0,61,61
20,3,20_3,M13,0,54,54
20,3,20_3,M14,0,86,86
20,3,20_3,B1,45,5,50
20,3,20_3,B2,17,10,27
20,3,20_3,B3,10,22,32
20,3,20_3,B4,1,22,23
40,3,40_3,M1,91,6,97
40,3,40_3,M2,46,12,58
40,3,40_3,M3,45,25,70
40,3,40_3,M4,48,58,106
40,3,40_3,M5,43,90,133
40,3,40_3,M6,24,88,112
40,3,40_3,M7,35,80,115
40,3,40_3,M8,33,65,98
40,3,40_3,M9,33,90,123
40,3,40_3,M10,22,78,100
40,3,40_3,M11,0,97,97
40,3,40_3,M12,0,56,56
40,3,40_3,M13,0,59,59
40,3,40_3,M14,0,41,41
40,3,40_3,B1,15,1,16
40,3,40_3,B2,3,3,6
40,3,40_3,B3,63,9,72
40,3,40_3,B4,19,12,31
40,3,40_3,B5,14,25,39
40,3,40_3,B6,6,28,34
40,3,40_3,B7,60,2,62
40,3,40_3,B8,30,7,37
40,3,40_3,B9,21,18,39
40,3,40_3,B10,17,29,46
40,3,40_3,B11,1,31,32
40,3,40_3,B12,46,4,50
40,3,40_3,B13,18,9,27
40,3,40_3,B14,12,17,29
40,3,40_3,B15,3,20,23
60,3,60_3,M1,77,11,88
60,3,60_3,M2,47,16,63
60,3,60_3,M3,49,39,88
60,3,60_3,M4,50,76,126
60,3,60_3,M5,48,89,137
60,3,60_3,M6,47,85,132
60,3,60_3,M7,50,82,132
60,3,60_3,M8,40,65,105
60,3,60_3,M9,34,59,93
60,3,60_3,M10,12,61,73
60,3,60_3,M11,0,60,60
60,3,60_3,M12,0,36,36
60,3,60_3,M13,0,49,49
60,3,60_3,M14,0,66,66
60,3,60_3,B1,9,3,12
60,3,60_3,B2,14,2,16
60,3,60_3,B3,2,3,5
60,3,60_3,B4,4,1,5
60,3,60_3,B5,1,1,2
60,3,60_3,B6,26,5,31
60,3,60_3,B7,9,7,16
60,3,60_3,B8,3,7,10
60,3,60_3,B9,59,3,62
60,3,60_3,B10,33,5,38
60,3,60_3,B11,25,20,45
60,3,60_3,B12,18,29,47
60,3,60_3,B13,6,24,30
60,3,60_3,B14,70,4,74
60,3,60_3,B15,35,8,43
60,3,60_3,B16,23,26,49
60,3,60_3,B17,10,50,60
60,3,60_3,B18,1,30,31
10,4,10_4,M1,50,5,55
10,4,10_4,M2,35,7,42
10,4,10_4,M3,33,16,49
10,4,10_4,M4,34,30,64
10,4,10_4,M5,35,61,96
10,4,10_4,M6,36,93,129
10,4,10_4,M7,38,100,138
10,4,10_4,M8,56,17,73
10,4,10_4,M9,15,84,99
10,4,10_4,M10,26,86,112
10,4,10_4,M11,5,89,94
10,4,10_4,M12,0,80,80
10,4,10_4,M13,0,65,65
10,4,10_4,M14,0,98,98
10,4,10_4,B1,60,9,69
10,4,10_4,B2,24,12,36
10,4,10_4,B3,26,29,55
10,4,10_4,B4,12,45,57
10,4,10_4,B5,7,1,8
10,4,10_4,B6,6,3,9
10,4,10_4,B7,0,9,9
10,4,10_4,B8,0,21,21
10,4,10_4,B9,0,23,23
20,4,20_4,M1,67,6,73
20,4,20_4,M2,37,9,46
20,4,20_4,M3,36,19,55
20,4,20_4,M4,42,47,89
20,4,20_4,M5,37,68,105
20,4,20_4,M6,39,77,116
20,4,20_4,M7,38,78,116
20,4,20_4,M8,30,66,96
20,4,20_4,M9,26,54,80
20,4,20_4,M10,14,59,73
20,4,20_4,M11,0,55,55
20,4,20_4,M12,12,46,58
20,4,20_4,M13,0,39,39
20,4,20_4,M14,0,32,32
20,4,20_4,M15,0,61,61
20,4,20_4,M16,0,82,82
20,4,20_4,B1,12,1,13
20,4,20_4,B2,5,1,6
20,4,20_4,B3,30,5,35
20,4,20_4,B4,10,8,18
20,4,20_4,B5,11,14,25
20,4,20_4,B6,6,18,24
20,4,20_4,B7,5,1,6
20,4,20_4,B8,1,1,2
20,4,20_4,B9,26,3,29
20,4,20_4,B10,11,9,20
20,4,20_4,B11,9,14,23
20,4,20_4,B12,1,10,11
20,4,20_4,B13,49,8,57
20,4,20_4,B14,18,10,28
20,4,20_4,B15,9,26,35
20,4,20_4,B16,2,24,26
20,4,20_4,B17,21,7,28
20,4,20_4,B18,8,18,26
20,4,20_4,B19,1,26,27
20,4,20_4,B20,1,36,37
20,4,20_4,B21,0,28,28
40,4,40_4,M1,78,8,86
40,4,40_4,M2,36,8,44
40,4,40_4,M3,40,18,58
40,4,40_4,M4,42,44,86
40,4,40_4,M5,44,88,132
40,4,40_4,M6,42,128,170
40,4,40_4,M7,54,145,199
40,4,40_4,M8,55,149,204
40,4,40_4,M9,46,139,185
40,4,40_4,M10,18,112,130
40,4,40_4,M11,35,130,165
40,4,40_4,M12,68,113,181
40,4,40_4,M13,0,81,81
40,4,40_4,M14,0,87,87
40,4,40_4,M15,0,74,74
40,4,40_4,M16,0,59,59
40,4,40_4,B1,8,2,10
40,4,40_4,B2,12,3,15
40,4,40_4,B3,31,4,35
40,4,40_4,B4,14,5,19
40,4,40_4,B5,10,14,24
40,4,40_4,B6,31,12,43
40,4,40_4,B7,50,6,56
40,4,40_4,B8,27,28,55
40,4,40_4,B9,21,31,52
40,4,40_4,B10,12,37,49
40,4,40_4,B11,8,47,55
40,4,40_4,B12,45,5,50
40,4,40_4,B13,30,11,41
40,4,40_4,B14,35,22,57
40,4,40_4,B15,27,43,70
40,4,40_4,B16,20,56,76
40,4,40_4,B17,20,56,76
40,4,40_4,B18,7,48,55
40,4,40_4,B19,3,3,6
40,4,40_4,B20,1,8,9
40,4,40_4,B21,0,8,8
40,4,40_4,B22,0,1,1
40,4,40_4,B23,0,1,1
40,4,40_4,B24,0,1,1
40,4,40_4,B25,0,1,1
60,4,60_4,M1,29,8,37
60,4,60_4,M2,39,26,65
60,4,60_4,M3,45,46,91
60,4,60_4,M4,48,82,130
60,4,60_4,M5,47,93,140
60,4,60_4,M6,52,82,134
60,4,60_4,M7,49,75,124
60,4,60_4,M8,45,58,103
60,4,60_4,M9,34,46,80
60,4,60_4,M10,18,45,63
60,4,60_4,M11,11,39,50
60,4,60_4,M12,0,31,31
60,4,60_4,M13,0,10,10
60,4,60_4,M14,0,34,34
60,4,60_4,M15,0,12,12
60,4,60_4,M16,0,43,43
60,4,60_4,M17,0,70,70
60,4,60_4,B1,13,4,17
60,4,60_4,B2,7,1,8
60,4,60_4,B3,10,7,17
60,4,60_4,B4,14,1,15
60,4,60_4,B5,8,4,12
60,4,60_4,B6,1,9,10
60,4,60_4,B7,13,1,14
60,4,60_4,B8,1,1,2
60,4,60_4,B9,14,1,15
60,4,60_4,B10,16,2,18
60,4,60_4,B11,2,3,5
60,4,60_4,B12,1,4,5
60,4,60_4,B13,8,1,9
60,4,60_4,B14,2,3,5
60,4,60_4,B15,0,1,1
60,4,60_4,B16,0,4,4
10,5,10_5,M1,68,6,74
10,5,10_5,M2,40,9,49
10,5,10_5,M3,45,28,73
10,5,10_5,M4,47,69,116
10,5,10_5,M5,38,91,129
10,5,10_5,M6,37,88,125
10,5,10_5,M7,34,90,124
10,5,10_5,M8,33,78,111
10,5,10_5,M9,44,76,120
10,5,10_5,M10,14,90,104
10,5,10_5,M11,0,65,65
10,5,10_5,M12,0,73,73
10,5,10_5,M13,0,136,136
10,5,10_5,B1,9,3,12
10,5,10_5,B2,1,23,24
10,5,10_5,B3,58,6,64
10,5,10_5,B4,21,5,26
10,5,10_5,B5,16,16,32
10,5,10_5,B6,10,25,35
10,5,10_5,B7,3,27,30
10,5,10_5,B8,51,4,55
10,5,10_5,B9,10,7,17
10,5,10_5,B10,6,15,21
10,5,10_5,B11,2,18,20
10,5,10_5,B12,1,30,31
10,5,10_5,B13,0,36,36
10,5,10_5,B14,0,28,28
20,5,20_5,M1,71,16,87
20,5,20_5,M2,30,10,40
20,5,20_5,M3,31,22,53
20,5,20_5,M4,34,46,80
20,5,20_5,M5,35,78,113
20,5,20_5,M6,37,98,135
20,5,20_5,M7,43,113,156
20,5,20_5,M8,40,103,143
20,5,20_5,M9,20,97,117
20,5,20_5,M10,18,112,130
20,5,20_5,M11,0,122,122
20,5,20_5,M12,0,112,112
20,5,20_5,M13,0,119,119
20,5,20_5,M14,0,140,140
20,5,20_5,B1,11,8,19
20,5,20_5,B2,12,6,18
20,5,20_5,B3,10,12,22
20,5,20_5,B4,5,18,23
20,5,20_5,B5,28,6,34
20,5,20_5,B6,28,12,40
20,5,20_5,B7,22,28,50
20,5,20_5,B8,19,41,60
20,5,20_5,B9,9,38,47
20,5,20_5,B10,29,6,35
20,5,20_5,B11,11,2,13
20,5,20_5,B12,9,15,24
20,5,20_5,B13,0,14,14
20,5,20_5,B14,1,1,2
20,5,20_5,B15,5,3,8
20,5,20_5,B16,44,4,48
20,5,20_5,B17,23,21,44
20,5,20_5,B18,20,28,48
20,5,20_5,B19,15,29,44
20,5,20_5,B20,8,23,31
20,5,20_5,B21,0,8,8
20,5,20_5,B22,78,14,92
20,5,20_5,B23,21,32,53
20,5,20_5,B24,18,38,56
20,5,20_5,B25,8,29,37
20,5,20_5,B26,0,29,29
20,5,20_5,B27,0,47,47
20,5,20_5,B28,0,45,45
40,5,40_5,M1,48,16,64
40,5,40_5,M2,54,42,96
40,5,40_5,M3,46,76,122
40,5,40_5,M4,52,110,162
40,5,40_5,M5,47,109,156
40,5,40_5,M6,36,99,135
40,5,40_5,M7,37,103,140
40,5,40_5,M8,25,96,121
40,5,40_5,M9,24,91,115
40,5,40_5,M10,13,81,94
40,5,40_5,M11,0,63,63
40,5,40_5,M12,0,73,73
40,5,40_5,M13,0,82,82
40,5,40_5,B1,10,3,13
40,5,40_5,B2,11,6,17
40,5,40_5,B3,201,18,219
40,5,40_5,B4,18,26,44
40,5,40_5,B5,22,16,38
40,5,40_5,B6,41,6,47
40,5,40_5,B7,38,40,78
40,5,40_5,B8,18,7,25
40,5,40_5,B9,13,13,26
40,5,40_5,B10,10,23,33
40,5,40_5,B11,2,19,21
40,5,40_5,B12,64,12,76
40,5,40_5,B13,17,13,30
40,5,40_5,B14,15,30,45
40,5,40_5,B15,11,36,47
40,5,40_5,B16,3,31,34
40,5,40_5,B17,21,1,22
40,5,40_5,B18,9,10,19
40,5,40_5,B19,0,13,13
40,5,40_5,B20,0,12,12
40,5,40_5,B21,0,14,14
40,5,40_5,B22,0,14,14
60,5,60_5,M1,124,9,133
60,5,60_5,M2,58,14,72
60,5,60_5,M3,60,37,97
60,5,60_5,M4,700,63,763
60,5,60_5,M5,590,121,711
60,5,60_5,M6,54,140,194
60,5,60_5,M7,62,141,203
60,5,60_5,M8,54,122,176
60,5,60_5,M9,49,122,171
60,5,60_5,M10,22,141,163
60,5,60_5,M11,0,98,98
60,5,60_5,M12,0,83,83
60,5,60_5,M13,0,96,96
60,5,60_5,M14,0,119,119
60,5,60_5,B1,5,1,6
60,5,60_5,B2,4,1,5
60,5,60_5,B3,46,5,51
60,5,60_5,B4,19,25,44
60,5,60_5,B5,9,26,35
60,5,60_5,B6,4,1,5
60,5,60_5,B7,2,1,3
60,5,60_5,B8,74,8,82
60,5,60_5,B9,43,6,49
60,5,60_5,B10,40,23,63
60,5,60_5,B11,37,46,83
60,5,60_5,B12,25,71,96
60,5,60_5,B13,4,63,67
60,5,60_5,B14,5,1,6
60,5,60_5,B15,21,1,22
60,5,60_5,B16,16,4,20
60,5,60_5,B17,14,13,27
60,5,60_5,B18,8,17,25
60,5,60_5,B19,1,15,16
60,5,60_5,B20,48,6,54
60,5,60_5,B21,13,17,30
60,5,60_5,B22,8,29,37
60,5,60_5,B23,3,19,22
60,5,60_5,B24,74,7,81
60,5,60_5,B25,35,15,50
60,5,60_5,B26,25,34,59
60,5,60_5,B27,13,57,70
60,5,60_5,B28,5,42,47
60,5,60_5,B29,0,55,55
60,5,60_5,B30,0,57,57
60,5,60_5,B31,0,40,40
10,6,10_6,M1,47,1,48
10,6,10_6,M2,32,8,40
10,6,10_6,M3,33,14,47
10,6,10_6,M4,31,27,58
10,6,10_6,M5,35,44,79
10,6,10_6,M6,41,61,102
10,6,10_6,M7,40,65,105
10,6,10_6,M8,33,59,92
10,6,10_6,M9,12,52,64
10,6,10_6,M10,11,65,76
10,6,10_6,M11,7,61,68
10,6,10_6,M12,0,55,55
10,6,10_6,M13,0,65,65
10,6,10_6,M14,0,51,51
10,6,10_6,M15,0,94,94
10,6,10_6,B1,45,6,51
10,6,10_6,B2,24,8,32
10,6,10_6,B3,18,16,34
10,6,10_6,B4,14,29,43
10,6,10_6,B5,4,25,29
10,6,10_6,B6,36,1,37
10,6,10_6,B7,17,4,21
10,6,10_6,B8,12,14,26
10,6,10_6,B9,7,16,23
10,6,10_6,B10,3,16,19
10,6,10_6,B11,0,6,6
10,6,10_6,B12,0,6,6
10,6,10_6,B13,0,9,9
20,6,20_6,M1,96,7,103
20,6,20_6,M2,44,13,57
20,6,20_6,M3,47,27,74
20,6,20_6,M4,50,70,120
20,6,20_6,M5,46,101,147
20,6,20_6,M6,38,120,158
20,6,20_6,M7,42,111,153
20,6,20_6,M8,36,99,135
20,6,20_6,M9,39,96,135
20,6,20_6,M10,30,109,139
20,6,20_6,M11,12,99,111
20,6,20_6,M12,0,72,72
20,6,20_6,M13,0,79,79
20,6,20_6,B1,8,1,9
20,6,20_6,B2,12,4,16
20,6,20_6,B3,27,3,30
20,6,20_6,B4,11,8,19
20,6,20_6,B5,2,10,12
20,6,20_6,B6,72,6,78
20,6,20_6,B7,34,8,42
20,6,20_6,B8,29,18,47
20,6,20_6,B9,25,37,62
20,6,20_6,B10,18,56,74
20,6,20_6,B11,6,56,62
20,6,20_6,B12,13,6,19
20,6,20_6,B13,0,15,15
20,6,20_6,B14,9,20,29
20,6,20_6,B15,1,22,23
20,6,20_6,B16,7,1,8
40,6,40_6,M1,94,10,104
40,6,40_6,M2,50,11,61
40,6,40_6,M3,48,27,75
40,6,40_6,M4,44,52,96
40,6,40_6,M5,43,78,121
40,6,40_6,M6,41,83,124
40,6,40_6,M7,39,76,115
40,6,40_6,M8,37,60,97
40,6,40_6,M9,33,53,86
40,6,40_6,M10,34,57,91
40,6,40_6,M11,18,50,68
40,6,40_6,M12,12,41,53
40,6,40_6,M13,0,59,59
40,6,40_6,M14,0,50,50
40,6,40_6,M15,0,133,133
40,6,40_6,B1,4,1,5
40,6,40_6,B2,11,1,12
40,6,40_6,B3,13,1,14
40,6,40_6,B4,7,4,11
40,6,40_6,B5,39,7,46
40,6,40_6,B6,13,18,31
40,6,40_6,B7,1,19,20
40,6,40_6,B8,72,7,79
40,6,40_6,B9,39,10,49
40,6,40_6,B10,38,18,56
40,6,40_6,B11,42,35,77
40,6,40_6,B12,36,47,83
40,6,40_6,B13,38,48,86
40,6,40_6,B14,25,49,74
40,6,40_6,B15,10,54,64
40,6,40_6,B16,0,62,62
40,6,40_6,B17,0,66,66
40,6,40_6,B18,0,40,40
40,6,40_6,B19,7,1,8
40,6,40_6,B20,0,1,1
40,6,40_6,B21,2,1,3
40,6,40_6,B22,1,4,5
40,6,40_6,B23,0,7,7
40,6,40_6,B24,0,17,17
60,6,60_6,M1,83,10,93
60,6,60_6,M2,54,13,67
60,6,60_6,M3,53,29,82
60,6,60_6,M4,40,52,92
60,6,60_6,M5,34,79,113
60,6,60_6,M6,30,82,112
60,6,60_6,M7,30,66,96
60,6,60_6,M8,19,54,73
60,6,60_6,M9,13,58,71
60,6,60_6,M10,0,48,48
60,6,60_6,M11,0,39,39
60,6,60_6,M12,0,35,35
60,6,60_6,M13,0,50,50
60,6,60_6,M14,0,29,29
60,6,60_6,M15,0,99,99
60,6,60_6,B1,22,1,23
60,6,60_6,B2,11,7,18
60,6,60_6,B3,7,13,20
60,6,60_6,B4,4,12,16
60,6,60_6,B5,28,3,31
60,6,60_6,B6,19,7,26
60,6,60_6,B7,16,17,33
60,6,60_6,B8,7,19,26
60,6,60_6,B9,1,13,14
60,6,60_6,B10,22,3,25
60,6,60_6,B11,9,11,20
60,6,60_6,B12,8,16,24
60,6,60_6,B13,0,10,10
60,6,60_6,B14,28,33,61
60,6,60_6,B15,16,10,26
60,6,60_6,B16,15,18,33
60,6,60_6,B17,5,19,24
60,6,60_6,B18,0,13,13
60,6,60_6,B19,75,8,83
60,6,60_6,B20,41,10,51
60,6,60_6,B21,42,25,67
60,6,60_6,B22,34,43,77
60,6,60_6,B23,30,61,91
60,6,60_6,B24,19,59,78
60,6,60_6,B25,0,38,38
10,7,10_7,M1,101,13,114
10,7,10_7,M2,37,16,53
10,7,10_7,M3,32,30,62
10,7,10_7,M4,35,56,91
10,7,10_7,M5,32,75,107
10,7,10_7,M6,33,62,95
10,7,10_7,M7,14,51,65
10,7,10_7,M8,25,56,81
10,7,10_7,M9,20,65,85
10,7,10_7,M10,0,57,57
10,7,10_7,M11,0,52,52
10,7,10_7,M12,0,54,54
10,7,10_7,M13,0,98,98
10,7,10_7,B1,20,2,22
10,7,10_7,B2,10,7,17
10,7,10_7,B3,2,10,12
10,7,10_7,B4,63,6,69
10,7,10_7,B5,2,23,25
10,7,10_7,B6,15,11,26
10,7,10_7,B7,11,19,30
10,7,10_7,B8,58,8,66
10,7,10_7,B9,15,11,26
10,7,10_7,B10,10,22,32
10,7,10_7,B11,3,27,30
10,7,10_7,B12,0,27,27
10,7,10_7,B13,0,27,27
10,7,10_7,B14,0,24,24
10,7,10_7,B15,0,25,25
20,7,20_7,M1,69,8,77
20,7,20_7,M2,34,10,44
20,7,20_7,M3,37,17,54
20,7,20_7,M4,35,40,75
20,7,20_7,M5,36,54,90
20,7,20_7,M6,34,50,84
20,7,20_7,M7,34,48,82
20,7,20_7,M8,22,45,67
20,7,20_7,M9,24,45,69
20,7,20_7,M10,9,38,47
20,7,20_7,M11,0,39,39
20,7,20_7,M12,0,32,32
20,7,20_7,M13,0,30,30
20,7,20_7,M14,0,50,50
20,7,20_7,B1,7,1,8
20,7,20_7,B2,1,1,2
20,7,20_7,B3,24,5,29
20,7,20_7,B4,9,9,18
20,7,20_7,B5,3,8,11
40,7,40_7,M1,78,5,83
40,7,40_7,M2,45,8,53
40,7,40_7,M3,41,17,58
40,7,40_7,M4,42,33,75
40,7,40_7,M5,41,70,111
40,7,40_7,M6,43,88,131
40,7,40_7,M7,34,78,112
40,7,40_7,M8,34,73,107
40,7,40_7,M9,30,62,92
40,7,40_7,M10,22,54,76
40,7,40_7,M11,10,41,51
40,7,40_7,M12,0,46,46
40,7,40_7,M13,0,35,35
40,7,40_7,M14,0,80,80
40,7,40_7,B1,10,1,11
40,7,40_7,B2,9,1,10
40,7,40_7,B3,8,1,9
40,7,40_7,B4,28,3,31
40,7,40_7,B5,11,9,20
40,7,40_7,B6,5,13,18
40,7,40_7,B7,44,3,47
40,7,40_7,B8,16,13,29
40,7,40_7,B9,11,22,33
40,7,40_7,B10,6,22,28
40,7,40_7,B11,1,3,4
40,7,40_7,B12,14,5,19
40,7,40_7,B13,11,1,12
40,7,40_7,B14,1,2,3
40,7,40_7,B15,47,4,51
40,7,40_7,B16,15,9,24
40,7,40_7,B17,12,22,34
40,7,40_7,B18,3,22,25
40,7,40_7,B19,16,2,18
40,7,40_7,B20,3,9,12
40,7,40_7,B21,0,12,12
40,7,40_7,B22,0,22,22
60,7,60_7,M1,48,1,49
60,7,60_7,M2,46,5,51
60,7,60_7,M3,48,12,60
60,7,60_7,M4,42,21,63
60,7,60_7,M5,40,44,84
60,7,60_7,M6,49,64,113
60,7,60_7,M7,39,25,64
60,7,60_7,M8,38,63,101
60,7,60_7,M9,34,52,86
60,7,60_7,M10,23,48,71
60,7,60_7,M11,23,50,73
60,7,60_7,M12,25,61,86
60,7,60_7,M13,0,47,47
60,7,60_7,M14,0,52,52
60,7,60_7,M15,0,87,87
60,7,60_7,B1,4,1,5
60,7,60_7,B2,4,1,5
60,7,60_7,B3,28,2,30
60,7,60_7,B4,15,8,23
60,7,60_7,B5,9,14,23
60,7,60_7,B6,4,18,22
60,7,60_7,B7,38,1,39
60,7,60_7,B8,25,8,33
60,7,60_7,B9,10,25,35
60,7,60_7,B10,1,19,20
60,7,60_7,B11,5,10,15
60,7,60_7,B12,0,8,8
60,7,60_7,B13,0,13,13
60,7,60_7,B14,0,12,12
60,7,60_7,B15,0,11,11
